105 105 105 105 105 105 105 105 105 105 105 105 105 105 105 105 105 105 105 105 105 105 105 105 105 105 105 105 105 105 105 105 105 105 105 105 105 105 105 105 105 105 105 105 105 105 105 105 105 105 
105 105 105 105 105 105 105 105 105 105 105 105 105 105 105 105 105 105 105 105 105 105 105 105 105 105 105 105 105 105 105 105 105 105 105 105 105 105 105 105 105 105 105 105 105 105 105 105 105 105 
105 105 105 105 105 105 105 105 105 105 105 105 105 105 105 105 105 105 105 105 105 105 105 105 105 105 105 105 105 105 105 105 105 105 105 105 105 105 105 105 105 105 105 105 105 105 105 105 105 105 
105 105 105 105 105 105 105 105 105 105 105 105 105 105 105 105 105 105 105 105 105 105 105 105 105 105 105 105 105 105 130 129 114 114 131 160 130 129 114 114 114 114 131 160 105 105 105 105 105 105 
105 105 105 130 129 114 114 114 114 114 114 114 114 114 131 160 105 105 105 105 105 105 105 105 105 105 105 105 105 105 109 128 127 128 136 129 131 115 115 140 140 115 115 111 105 105 105 105 105 105 
105 105 105 109 115 140 140 115 115 143 115 140 140 115 115 111 105 105 105 105 105 105 105 105 105 105 105 105 105 105 109 128 128 128 135 115 115 126 126 141 139 126 126 111 105 105 105 105 105 105 
105 105 105 109 126 141 139 126 126 144 126 141 139 126 126 129 129 114 131 160 105 105 105 105 105 105 105 105 105 105 109 132 132 132 132 126 126 125 125 137 138 125 125 111 105 105 105 105 105 105 
105 105 105 109 125 137 138 125 125 125 125 137 138 125 125 115 115 106 115 111 105 105 105 105 105 105 105 105 105 105 109 108 107 124 108 125 125 108 107 107 107 107 107 111 105 105 105 105 105 105 
105 105 105 109 108 107 107 107 107 107 107 107 107 107 107 126 126 126 126 111 105 105 105 105 105 105 105 105 105 105 109 108 107 161 142 107 107 107 107 107 107 107 107 111 105 105 105 105 105 105 
105 105 105 109 108 107 107 107 107 107 107 107 107 107 107 123 125 125 125 111 105 105 105 105 105 105 105 105 105 105 109 116 116 121 107 107 107 107 153 152 152 152 151 111 105 105 105 105 105 105 
105 105 105 109 108 153 152 152 152 152 151 107 107 107 107 162 107 107 107 111 105 105 105 105 105 105 105 105 105 105 109 112 112 117 107 107 107 107 148 149 149 149 150 111 105 105 105 105 105 105 
105 105 105 109 108 148 149 149 149 149 150 107 107 107 107 122 116 116 116 111 105 105 105 105 105 105 105 105 105 105 109 108 107 107 107 158 159 108 148 149 149 149 150 111 105 105 105 105 105 105 
105 105 105 109 108 148 149 149 149 149 150 107 107 107 107 118 112 112 112 111 105 105 105 105 105 105 105 105 105 105 109 108 107 107 107 111 109 108 147 146 146 146 145 111 105 105 105 105 105 105 
105 105 105 109 108 148 149 149 149 149 150 107 107 107 107 107 107 107 107 111 105 105 105 105 105 105 105 105 105 105 109 108 107 107 107 111 109 108 107 107 107 107 107 111 105 105 105 105 105 105 
105 105 105 109 108 147 146 146 146 146 145 107 158 159 107 153 152 151 107 111 105 105 105 105 105 105 105 105 105 105 110 156 157 158 119 113 110 119 119 119 119 119 119 113 105 105 105 105 105 105 
105 105 105 109 108 107 107 107 107 107 107 107 111 109 107 148 149 150 107 111 105 105 105 105 105 105 105 105 105 105 105 105 105 105 105 105 105 105 105 105 105 105 105 105 105 105 105 105 105 105 
105 105 105 109 108 107 107 107 107 107 107 107 111 109 107 148 149 150 107 111 105 105 105 105 105 105 105 105 105 105 105 105 105 105 105 105 105 105 105 105 105 105 105 105 105 105 105 105 105 105 
105 105 105 110 119 119 119 119 119 119 119 119 113 110 119 156 155 154 119 113 105 105 105 105 105 105 105 105 105 105 105 105 105 105 105 105 105 105 105 105 105 105 105 105 105 105 105 105 105 105 
105 105 105 105 105 105 105 105 105 105 105 105 105 105 105 105 105 105 105 105 105 105 105 105 105 105 105 105 105 105 105 105 105 105 105 105 105 105 105 105 105 105 105 105 105 105 105 105 105 105 
105 105 105 105 105 105 105 105 105 105 105 105 105 105 105 105 105 105 105 105 105 105 105 105 105 105 105 105 105 105 105 105 105 105 105 105 105 105 105 105 105 105 105 105 105 105 105 105 105 105 
105 105 105 105 105 105 105 105 105 105 105 105 105 105 105 105 105 105 105 105 105 105 105 105 105 105 105 105 105 105 105 105 105 105 105 105 105 105 105 105 105 105 105 105 105 105 105 105 105 105 
105 105 105 105 105 105 105 105 105 105 105 105 105 105 105 105 105 105 105 105 105 105 105 105 105 105 105 105 105 105 105 105 105 105 105 105 105 105 105 105 105 105 105 105 105 105 105 105 105 105 
105 105 105 105 105 105 105 105 105 105 105 105 105 105 105 105 105 105 105 105 105 105 105 105 105 105 105 105 105 105 105 105 105 105 105 105 105 105 105 105 105 105 105 105 105 105 105 105 105 105 
105 105 105 105 105 105 105 105 105 105 105 105 105 105 105 105 105 105 105 105 105 105 105 105 105 105 105 105 105 105 105 105 105 105 105 105 105 105 105 105 105 105 105 105 105 105 105 105 105 105 
105 105 105 105 105 105 105 105 105 105 105 105 105 105 105 105 105 105 105 105 105 105 105 105 105 105 105 105 105 105 105 105 105 105 105 105 105 105 105 105 105 105 105 105 105 105 105 105 105 105 
105 105 105 105 105 105 105 105 105 105 105 105 105 105 105 105 105 105 105 105 105 105 105 105 105 105 105 105 105 105 105 105 105 105 105 105 105 105 105 105 105 105 105 105 105 105 105 105 105 105 
105 105 105 105 105 105 105 105 105 105 105 105 105 105 105 105 105 105 105 105 105 105 105 105 105 105 105 105 105 105 105 105 105 105 105 105 105 105 105 105 105 105 105 105 105 105 105 105 105 105 
105 105 105 105 105 105 105 105 105 105 105 105 105 105 105 105 105 105 105 105 105 105 105 105 105 105 105 105 105 105 105 105 105 105 105 105 105 105 105 105 105 105 105 105 105 105 105 105 105 105 
105 105 105 105 105 105 105 105 105 105 105 105 105 105 105 105 105 105 105 105 105 105 105 105 105 105 105 105 105 105 105 105 105 105 105 105 105 105 105 105 105 105 105 105 105 105 105 105 105 105 
105 105 105 105 105 105 105 105 105 105 105 105 130 129 114 114 114 114 114 114 114 114 114 114 114 114 114 114 131 160 105 105 105 105 105 105 105 105 105 105 105 105 105 105 105 105 105 105 105 105 
105 105 105 105 105 105 105 105 105 105 105 105 109 115 115 115 115 143 115 115 115 115 115 115 143 115 115 115 115 111 105 105 105 105 105 105 105 105 105 105 105 105 105 105 105 105 105 105 105 105 
105 105 105 105 105 105 105 105 105 105 105 105 109 126 126 120 126 144 126 126 126 126 126 126 144 126 134 126 126 111 105 105 105 105 105 105 105 105 105 105 105 105 105 105 105 105 105 105 105 105 
105 105 105 105 105 105 105 105 105 105 105 105 109 123 125 125 125 124 125 125 125 125 125 125 123 125 125 125 124 111 105 105 105 105 105 105 105 105 105 105 105 105 105 105 105 105 105 105 105 105 
105 105 105 105 105 105 105 105 105 105 105 105 109 162 107 107 107 161 108 107 107 107 107 107 162 107 107 107 161 111 105 105 105 105 105 105 105 105 105 105 105 105 105 105 105 105 105 105 105 105 
105 105 105 105 105 105 105 105 105 105 105 105 109 122 116 116 116 121 142 107 107 107 107 107 122 116 116 116 121 111 105 105 105 105 105 105 105 105 105 105 105 105 105 105 105 105 105 105 105 105 
105 105 105 105 105 105 105 105 105 105 105 105 109 118 112 112 112 117 107 107 107 107 107 107 118 112 112 112 117 111 105 105 105 105 105 105 105 105 105 105 105 105 105 105 105 105 105 105 105 105 
105 105 105 105 105 105 105 105 105 105 105 105 109 108 107 107 107 107 107 107 107 107 107 107 107 107 107 107 107 111 105 105 105 105 105 105 105 105 105 105 105 105 105 105 105 105 105 105 105 105 
105 105 105 105 105 105 105 105 105 105 105 105 109 108 107 107 107 107 107 107 107 107 107 107 107 107 107 107 107 111 105 105 105 105 105 105 105 105 105 105 105 105 105 105 105 105 105 105 105 105 
105 105 105 105 105 105 105 105 105 105 105 105 109 108 153 152 151 107 158 119 119 119 119 159 108 153 152 151 107 111 105 105 105 105 105 105 105 105 105 105 105 105 105 105 105 105 105 105 105 105 
105 105 105 105 105 105 105 105 105 105 105 105 109 108 148 149 150 107 111 105 105 105 105 109 108 148 149 150 107 111 105 105 105 105 105 105 105 105 105 105 105 105 105 105 105 105 105 105 105 105 
105 105 105 105 105 105 105 105 105 105 105 105 109 108 148 149 150 107 111 105 105 105 105 109 108 148 149 150 107 111 105 105 105 105 105 105 105 105 105 105 105 105 105 105 105 105 105 105 105 105 
105 105 105 105 105 105 105 105 105 105 105 105 110 119 156 155 154 119 113 105 105 105 105 110 119 156 155 154 119 113 105 105 105 105 105 105 105 105 105 105 105 105 105 105 105 105 105 105 105 105 
105 105 105 105 105 105 105 105 105 105 105 105 105 105 105 105 105 105 105 105 105 105 105 105 105 105 105 105 105 105 105 105 105 105 105 105 105 105 105 105 105 105 105 105 105 105 105 105 105 105 
105 105 105 105 105 105 105 105 105 105 105 105 105 105 105 105 105 105 105 105 105 105 105 105 105 105 105 105 105 105 105 105 105 105 105 105 105 105 105 105 105 105 105 105 105 105 105 105 105 105 
105 105 105 105 105 105 105 105 105 105 105 105 105 105 105 105 105 105 105 105 105 105 105 105 105 105 105 105 105 105 105 105 105 105 105 105 105 105 105 105 105 105 105 105 105 105 105 105 105 105 
105 105 105 105 105 105 105 105 105 105 105 105 105 105 105 105 105 105 105 105 105 105 105 105 105 105 105 105 105 105 105 105 105 105 105 105 105 105 105 105 105 105 105 105 105 105 105 105 105 105 
105 105 105 105 105 105 105 105 105 105 105 105 105 105 105 105 105 105 105 105 105 105 105 105 105 105 105 105 105 105 105 105 105 105 105 105 105 105 105 105 105 105 105 105 105 105 105 105 105 105 
105 105 105 105 105 105 105 105 105 105 105 105 105 105 105 105 105 105 105 105 105 105 105 105 105 105 105 105 105 105 105 105 105 105 105 105 105 105 105 105 105 105 105 105 105 105 105 105 105 105 
105 105 105 105 105 105 105 105 105 105 105 105 105 105 105 105 105 105 105 105 105 105 105 105 105 105 105 105 105 105 105 105 105 105 105 105 105 105 105 105 105 105 105 105 105 105 105 105 105 105 
105 105 105 105 105 105 105 105 105 105 105 105 105 105 105 105 105 105 105 105 105 105 105 105 105 105 105 105 105 105 105 105 105 105 105 105 105 105 105 105 105 105 105 105 105 105 105 105 105 105 
