0 0 0 0 0 0 0 0 0 0 0 0 0 0 0 0 0 0 0 0 0 0 0 0 0 0 0 0 0 0 0 0 0 0 0 0 0 0 0 0 0 0 0 0 0 0 0 0 0 0 
0 0 0 0 0 0 0 0 0 0 0 0 0 0 0 0 0 0 0 0 0 0 0 0 0 0 0 0 0 0 0 0 0 0 0 0 0 0 0 0 0 0 0 0 0 0 0 0 0 0 
0 0 0 0 0 0 0 0 0 0 0 0 0 102 91 91 91 91 91 91 91 91 91 91 91 91 91 91 91 91 91 91 101 0 0 0 0 0 0 0 0 0 0 0 0 0 0 0 0 0 
0 0 0 0 0 0 0 0 0 0 0 0 102 90 86 86 86 86 86 86 86 86 86 86 86 86 86 86 86 86 86 87 92 101 0 0 0 0 0 0 0 0 0 0 0 0 0 0 0 0 
0 0 0 0 0 0 0 0 0 0 0 102 90 85 85 81 81 81 81 81 81 81 81 81 81 81 81 81 81 81 81 85 87 92 101 0 0 0 0 0 0 0 0 0 0 0 0 0 0 0 
0 0 0 0 0 0 0 0 0 0 102 90 85 85 80 0 0 0 0 0 0 0 0 0 0 0 0 0 0 0 0 82 85 87 92 101 0 0 0 0 0 0 0 0 0 0 0 0 0 0 
0 0 0 0 0 0 0 0 0 102 90 87 85 80 0 0 0 0 0 0 0 0 0 0 0 0 0 0 0 0 0 0 82 85 87 92 101 0 0 0 0 0 0 0 0 0 0 0 0 0 
0 0 0 0 0 0 0 0 102 90 86 85 80 0 0 0 0 0 0 0 0 0 0 0 0 0 0 0 0 0 0 0 0 82 85 87 92 101 0 0 0 0 0 0 0 0 0 0 0 0 
0 0 0 0 0 0 0 102 90 86 87 80 0 0 0 0 0 27 0 0 0 0 0 0 0 2 2 0 0 0 0 0 0 0 82 85 87 92 101 0 0 0 0 0 0 0 0 0 0 0 
0 0 0 0 0 0 102 90 87 87 88 0 33 43 33 43 24 27 26 0 0 0 0 0 0 2 0 0 0 0 0 0 0 0 0 82 85 87 92 101 0 0 0 0 0 0 0 0 0 0 
0 0 0 0 0 0 96 85 85 88 79 0 20 42 20 42 24 25 26 0 0 0 0 0 0 2 2 0 0 0 0 0 2 0 0 0 82 85 87 92 101 0 0 0 0 0 0 0 0 0 
0 0 0 0 0 0 96 85 89 79 0 0 19 19 19 19 22 23 21 0 0 0 0 0 0 0 0 0 0 0 0 2 2 2 0 0 0 82 85 85 95 0 0 0 0 0 0 0 0 0 
0 0 0 0 0 0 96 85 89 0 0 0 18 30 32 18 19 14 19 0 0 0 0 0 0 0 0 2 2 2 0 0 0 0 0 0 0 0 93 85 95 0 0 0 0 0 0 0 0 0 
0 0 0 0 0 0 96 85 89 0 0 0 17 29 31 17 18 10 78 0 0 0 0 0 0 0 0 2 0 2 0 0 0 0 0 0 0 0 93 85 95 0 0 0 0 0 0 0 0 0 
0 0 0 0 0 0 96 85 89 0 0 0 0 2 2 0 7 8 9 0 0 0 0 0 0 0 0 0 0 0 0 2 0 0 0 0 0 0 93 85 95 0 0 0 0 0 0 0 0 0 
0 0 0 0 0 0 96 85 89 0 0 0 0 0 0 0 1 5 6 0 0 0 0 60 0 0 0 0 0 0 2 2 0 0 0 0 0 0 93 85 95 0 0 0 0 0 0 0 0 0 
0 0 0 0 0 0 96 85 89 0 0 0 0 0 0 0 0 4 0 0 0 0 0 0 0 0 0 0 0 0 0 2 2 0 0 0 0 0 93 85 95 0 0 0 0 0 0 0 0 0 
0 0 0 0 0 0 96 85 89 0 0 0 0 0 0 0 0 4 0 0 0 0 66 73 73 73 73 72 0 0 0 0 0 2 2 60 0 0 93 85 95 0 0 0 0 0 0 0 0 0 
0 0 0 0 0 0 96 85 89 0 0 0 0 0 0 0 0 4 0 0 66 73 74 74 74 74 74 74 72 0 0 0 0 0 0 2 0 0 93 85 95 0 0 0 0 0 0 0 0 0 
0 0 0 0 0 0 96 85 89 0 0 0 0 0 0 0 0 68 75 75 74 74 74 74 74 74 74 74 74 73 72 0 0 0 0 0 0 0 93 85 95 0 0 0 0 0 0 0 0 0 
0 0 0 0 0 0 96 85 89 0 0 0 0 0 2 0 0 0 0 66 74 74 74 74 74 74 74 74 74 74 74 72 0 0 0 0 0 0 93 85 95 0 0 0 0 0 0 0 0 0 
0 0 0 0 0 0 96 85 89 0 0 0 2 2 2 0 0 0 0 67 74 74 74 74 74 69 69 74 74 74 74 74 72 0 0 0 0 0 93 85 95 0 0 0 0 0 0 0 0 0 
0 0 0 0 0 0 96 85 89 0 0 0 0 0 0 0 0 0 66 74 74 74 74 74 70 0 0 68 74 74 74 74 71 0 0 0 0 0 93 85 95 0 0 0 0 0 0 0 0 0 
0 0 0 0 0 0 96 85 89 0 0 0 0 0 0 0 0 0 67 74 74 74 74 71 0 44 46 0 67 74 74 74 71 0 0 0 0 0 93 85 95 0 0 0 0 0 0 0 0 0 
0 0 0 0 0 0 96 85 89 0 0 0 0 0 0 0 0 0 67 74 74 74 74 71 0 45 47 0 67 74 74 74 71 0 0 0 0 0 93 85 95 0 0 0 0 0 0 0 0 0 
0 0 0 0 0 0 96 85 89 0 0 0 0 0 0 0 0 0 67 74 74 74 74 74 72 0 0 66 74 74 74 74 71 0 0 0 0 0 93 85 95 0 0 0 0 0 0 0 0 0 
0 0 0 0 0 0 96 85 89 0 0 0 0 60 2 2 0 0 67 74 74 74 74 74 74 73 73 74 74 74 74 74 70 0 0 60 0 0 93 85 95 0 0 0 0 0 0 0 0 0 
0 0 0 0 0 0 96 85 89 0 60 0 2 0 0 0 0 0 68 74 74 74 74 74 74 74 74 74 74 74 74 70 0 0 0 0 0 0 93 85 95 0 0 0 0 0 0 0 0 0 
0 0 0 0 0 0 96 85 89 0 0 0 0 0 0 0 0 0 0 68 74 74 74 74 74 74 74 74 74 74 70 0 0 0 0 0 0 0 93 85 95 0 0 0 0 0 0 0 0 0 
0 0 0 0 0 0 96 85 89 0 0 0 0 0 0 0 0 0 0 0 68 69 74 69 69 69 69 74 69 70 0 0 0 0 0 0 0 0 93 85 95 0 0 0 0 0 0 0 0 0 
0 0 0 0 0 0 96 85 89 0 0 0 27 0 0 0 0 0 0 27 0 0 76 0 0 0 0 76 0 0 0 0 0 0 0 2 0 0 93 85 95 0 0 0 0 0 0 0 0 0 
0 0 0 0 0 0 96 85 89 0 0 36 27 34 33 33 33 41 36 27 34 0 68 72 66 75 75 70 0 0 0 27 0 0 2 0 60 0 93 85 95 0 0 0 0 0 0 0 0 0 
0 0 0 0 0 0 96 85 89 0 0 37 27 35 20 20 20 20 37 27 35 59 0 67 70 0 0 0 0 0 36 27 34 0 0 0 0 0 93 85 95 0 0 0 0 0 0 0 0 0 
0 0 0 0 0 0 96 85 89 0 0 24 25 26 19 19 19 19 24 25 26 59 0 76 0 0 33 41 33 33 37 27 35 0 0 0 0 0 93 85 95 0 0 0 0 0 0 0 0 0 
0 0 0 0 0 0 96 85 89 0 0 22 23 21 18 18 30 32 22 23 21 59 0 76 0 0 20 20 20 20 24 25 26 59 0 0 0 0 93 85 95 0 0 0 0 0 0 0 0 0 
0 0 0 0 0 0 96 85 89 0 0 19 14 19 17 17 29 31 19 14 19 59 0 76 0 0 19 19 14 19 22 23 21 59 0 0 0 0 93 85 95 0 0 0 0 0 0 0 0 0 
0 0 0 0 0 0 96 85 89 0 0 18 10 12 15 28 0 0 11 10 13 59 0 76 0 0 18 18 10 77 19 19 19 15 0 0 0 0 93 85 95 0 0 0 0 0 0 0 0 0 
0 0 0 0 0 0 96 85 89 0 0 7 8 9 0 0 0 0 7 8 9 65 0 76 0 0 17 7 8 9 18 18 18 15 0 0 0 0 93 85 95 0 0 0 0 0 0 0 0 0 
0 0 0 0 0 0 96 85 89 0 0 1 5 6 0 0 0 0 1 5 6 0 0 4 0 0 0 1 5 6 17 17 17 65 0 0 0 0 93 85 95 0 0 0 0 0 0 0 0 0 
0 0 0 0 0 0 96 85 89 0 0 0 0 0 0 0 0 0 0 0 0 0 0 76 0 0 0 0 0 0 0 0 0 0 0 0 0 0 93 85 95 0 0 0 0 0 0 0 0 0 
0 0 0 0 0 0 96 85 89 0 0 0 0 0 0 0 0 0 0 0 0 0 0 76 0 0 0 0 0 0 0 2 0 0 0 0 0 0 93 85 95 0 0 0 0 0 0 0 0 0 
0 0 0 0 0 0 96 87 89 0 0 0 0 2 0 0 2 0 0 0 0 0 0 76 0 0 0 0 2 0 0 0 0 0 0 0 0 0 93 85 95 0 0 0 0 0 0 0 0 0 
0 0 0 0 0 0 96 87 89 0 0 0 0 0 0 2 0 0 0 0 0 0 0 4 0 0 0 2 0 2 0 0 0 0 0 0 0 0 93 85 95 0 0 0 0 0 0 0 0 0 
0 0 0 0 0 0 96 87 89 0 0 0 0 0 2 2 0 0 0 0 0 0 0 76 0 0 0 0 0 0 0 0 0 0 0 0 0 0 93 85 95 0 0 0 0 0 0 0 0 0 
0 0 0 0 0 0 96 87 89 0 0 0 0 0 0 0 0 0 0 0 0 0 0 3 0 0 0 0 0 0 0 0 0 0 0 0 0 0 93 85 95 0 0 0 0 0 0 0 0 0 
0 0 0 0 0 0 96 87 89 0 0 0 0 0 0 0 0 0 0 0 0 0 0 0 0 0 0 0 0 0 0 0 0 0 0 0 0 0 93 85 95 0 0 0 0 0 0 0 0 0 
0 0 0 0 0 0 104 100 100 100 100 100 100 100 100 100 100 100 100 100 100 100 100 100 100 100 100 100 100 100 100 100 100 100 100 100 100 100 100 100 103 0 0 0 0 0 0 0 0 0 
0 0 0 0 0 0 0 0 0 0 0 0 0 0 0 0 0 0 0 0 0 0 0 0 0 0 0 0 0 0 0 0 0 0 0 0 0 0 0 0 0 0 0 0 0 0 0 0 0 0 
0 0 0 0 0 0 0 0 0 0 0 0 0 0 0 0 0 0 0 0 0 0 0 0 0 0 0 0 0 0 0 0 0 0 0 0 0 0 0 0 0 0 0 0 0 0 0 0 0 0
0 0 0 0 0 0 0 0 0 0 0 0 0 0 0 0 0 0 0 0 0 0 0 0 0 0 0 0 0 0 0 0 0 0 0 0 0 0 0 0 0 0 0 0 0 0 0 0 0 0 
